job - задание
process group (первое употребление в абзаце) - группа процессов
process group (последующие употребления или в сочетании с process) - группа
group of processes - совокупность процессов
foreground job/process group - задание/группа (процессов) переднего плана
[TODO: может быть, «основное задание»?]
background job - фоновое задание
subshell - дочерний шелл
parent shell/process - родительский шелл/процесс
job control - управление заданиями
enable job control - начать управление заданиями
stop signals - сигналы останова
[TODO: может быть, «сигналы приостановки»?]
functions (fork, exec) - функции
single command - одиночная команда
session - сессия
session leader - лидер сессии
login (сущ-е, в системе) - логин
log in (действие, в системе) - авторизоваться
system login program - программа входа в систему
function fails - функция завершается неудачей
error code - код ошибки
controlling terminal - управляющий терминал
child process, subprocess - дочерний процесс
handler - обработчик
pipe - пайп
pipeline - конвеер
terminated job - завершённое задание
process has completed - процесс завершён
process has stopped - процесс приостановлен
race condition - состояние гонки
fork (глагол) the process - ответвите (или форкните) процесс
GNU system - система GNU
terminal modes - параметры терминала
sample shell - пример шелла
prompting - вывод приглашения
